0  0  0  0  0  1  1  1  1  1  1  1  1  1  1  1  1  1  1  1  1  1  1  1  1  1  1  1  1  1  1  1  1  1  1  1  1  1  1  1  1  0  0  0  0  0  0  0  0  0  1  1  1  1  1  1  1  1  1  1  1  1  1  1  1  1  1  1  1  1  1  1  1  1  1  1  1  1  1  1  0  0  0  0  0  0  0  0  0  0  0  0  0  0  0  1  1  1  1  1  1  1  5  5  8  8  8  8  5  5  5  5  5  5  5  5  5  5  5  5  6  6  6  6  6  6  6  6  6  6  6  6  6  6  6  6  6  6  6  6 11 11 11 11 11 11 11 11 11 11 11 11 11 11 11 11 11 11 11 11  1  1  1  1  1  1  1  1  1  1  1  5  5  5  5  5  5  5  5  5  1  1  1  1  1  1  1  1  1  1  1  1  1  6  6  1  1  1  1  1  
0  0  0  0  0  1  1  1  1  1  1  1  1  1  1  1  1  1  1  1  1  1  1  1  1  1  0  0  0  0  0  0  0  0  0  0  0  0  0  0  0  0  0  0  0  0  0  0  0  0  0  0  0  0  0  0  0  0  0  0  0  0  0  0  0  0  0  0  0  0  0  0  0  0  0  0  0  0  0  0  0  0  0  0  0  0  0  0  0  0  0  0  0  0  0  0  0  0  0  0  1  1  5  8  0  0  0  8  8  8  8  8  5  8  8  8  8  5  5  5  6  6  6  0  0  6  6  6  0  0  0  6  6  6  0  6  0  6  6  6  5  5  5  5  5  5  5  5  5  5  5  5  5  5  5  5  5  5  5  5  0  0  0  0  0  0  0  0  0  0  7  5  5  5  5  5  5  5  5  5  1  1  0  0  0  0  0  0  0  0  0  0  0  0  0  0  0  0  0  0  
0  0  0  0  0  0  0  0  0  0  0  0  0  0  0  0  0  0  0  0  0  0  0  0  0  0  0  0  0  0  0  0  0  0  0  0  0  0  0  0  0  0  0  0  0  0  0  0  0  0  0  0  0  0  0  0  0  0  0  0  0  0  0  0  0  0  0  0  0  0  0  0  0  0  0  0  0  0  0  0  0  0  0  0  0  0  0  0  0  0  0  0  0  0  0  0  0  0  0  0  1  1  8  8  0  8  0  0  0  0  0  8  5  8  0  0  8  8  5  5  0  0  0  0  0  6  6  0  0  0  0  0  0  6  0  0  0  0  0  0  0  0  0  0  0  0  0  0  0  0  0  0  0  0  0  0  0  0  0  0  0  0  0  0  0  0  0  0  0  0  7  5  5  5  5  5  5  5  5  5  1  0  0  0  0  0  0  0  0  0  0  0  0  0  0  0  0  0  0  0  
0  0  0  0  0  0  0  0  0  0  0  0  0  0  0  0  0  0  0  0  0  0  0  0  0  0  0  0  0  0  0  0  0  0  0  0  0  0  0  0  0  0  0  0  0  0  0  0  0  0  0  0  0  0  0  0  0  0  0  0  0  0  0  0  0  0  0  0  0  0  0  0  0  0  0  0  0  0  0  0  0  0  0  0  0  0  0  0  0  0  0  0  0  0  0  0  0  0  0  0  0  0  0  8  0  8  2  0  8  0  0  8  8  8  0  0  0  0  8  8  0  0  0  0  0  0  0  0  0  0  0  0  0  6  0  0  0  0  0  0  0  0  0  0  0  0  0  0  0  0  0  0  0  0  0  0  0  0  0  0  0  0  0  0  0  0  0  0  0  0  7  5  5  5  5  5  5  5  5  5  0  0  0  0  0  0  0  0  0  0  0  0  0  0  0  0  0  0  0  0  
0  0  0  0  0  0  0  0  0  0  0  0  0  0  0  0  0  0  0  0  0  0  0  0  0  0  0  0  0  0  0  0  0 10  0  0  0  0  0  0  0  0  0  0  0  0  0  0  0  0  0  0  0  0  0  0  0  0  0  0  0  0  0  0  0  0  0  0  0  0  0  0  0  0  0  0  0  0  0  0  0  0  0  0  0  0  0  0  0  0  0  0  0  0  0  0  0  0  0  0  0  0  0  0  0  0  9  0  8  2  0  0  0  0  0  0  0  0  0  0  0  0  0  0  0  0  0  0  0  0  0  0  0  0  0  0  0  0  0  0  0  0  0  0  0  0  0  0  0  2  0  0  0  0  0  0  0  0  0  6  3  3  0  0  3  3  0  0  0  0  7  5  5  5  5  5  5  5  5  5  0  0  0  0  0  0  0  0  0  0  0  0  0  0  0  0  0  0  0  0  
0  0  0  0  0  0  0  0  0  0  0  0  0  0  0  0  0  0  0  0  0  0  0  0  0  0  0  0  0  0 10  0  0  0  0  0  0  0  0  0  0  0  0  0  0  0  0  0  0  0  0  0  0  0  0  0  0  4  3  3  3  3  3  3  3  0  0  0  0  0  0  0  0  0  0  0  3  3  3  3  3  3  3  3  3  3  3  3  3  3  3  3  3  3  3  3  3  3  3  3  3  3  8  8  0  8  0  0  0  9  0  0  0  0  0  8  0  0  2  8  3  0  0  0  0  0  0  2  0  0  0  0  0  0  0 10  0  0  0  0  0  0  0  0  0  0  0  0  7  6  0  0  0  0  0  0  0  0  0  6  1  1  0  0  1  1  3  0  0  0  7  5  5  5  5  5  5  5  0  0  0  0  0  0  0  0  0  0  0  0  0  0  0  0  0  0  0  0  0  0  
0  0  0  0  0  0  0  0  0  0  0  0  0  0  3  3  0  0  0  0  0  0  0  0  0  0  0  0  0  0  0  0  0  0  0  3  3  3  3  3  0  0  0  0  0  0  0  0  0  0  0  0  0  0  0  9  0  1  1  1  1  1  1  1  1  0  0 10 10  0  0  0 10 10  0  0  1  1  1  1  1  1  1  1  1  1  1  1  1  1  1  1  1  1  1  1  1  1  1  1  1  1  5  8  0  0  0  0  0  0  0  2  8  0  0  0  0  8  9  5  1  3  0  0  0  0 10 10  0  0  0  0  0  0 10 11  0  0  0  0  0  0  0  0  0  0  0  0  0  0  0  0  0  0  0  0  0  0  0  6  1  1  0  0  1  1  1  0  0  0  7  5  5  5  5  5  5  5  0  3  9  9  0  0  0  0  0  0  0  0  0  0  0  0  0  0  0  0  0  0  
9  0  0  0  0  0  0  0  0  0  0  3  3  3  1  1  0  0  3  2  0  0  0  0  0  0  0 10  0  0  0  0  0  0  0  1  1  1  1  1  9  0  0  0  0  0  0  0  0  0  0  0  0  0  0  1  3  1  1  1  1  1  1  1  1  0  0  0  0  0  0  0  0  0  0  0  1  1  1  1  1  1  1  1  1  1  1  1  1  1  1  1  1  1  1  1  1  1  1  1  1  1  5  8  0  8  8  2  0  8  8  9  0  0  0  2  2  0  0  8  1  1  3  0  0  0  0  0  0  0  0  2  0  0  0  0  0  0  0  3  6  0  6  0  2  0  6  0  0  6  0  0  6  0  2  0  0  7  6  5  1  1  3  3  1  1  1  3  0  0  7  5  5  5  5  5  5  0  0  1  0 11  0  0  0  0  0  0  2  2  2  0  0  0  0  0  4  3  3  3  
9  9  0  0  0  0  0  0  0  3  3  1  1  1  1  1  2  2  1  9  3  0  0  0  0  0  0  0  0  0  0  0  0  0  0  1  1  1  1  1  9  9  0  0  0  0  0  0  0  0  0  0  0  3  3  1  1  1  1  1  1  1  1  1  1  0  0 10 10  0  0  0 10 10  0  0  1  1  1  1  1  1  1  1  1  1  1  1  1  1  1  1  1  1  1  1  1  1  1  1  1  1  5  8  0  7  8  8  8  8  0  0  0  2  8  9  9  8  8  8  1  1  1  2  0  0  0  0  0  0 10 10  0  0  0  0  0  0  0  0  5  0  5  0  6  0  5  0  0  5  0  0  7  0  6  0  2  6  5  5  1  1  1  1  1  1  1  1  0  0  0  0  0  0  0  0  0  0  3  1  0 11 10 10 10  0  0  0  6  6  6  0  0  0  0  0  0  0  0  0  
1  1  3  3  3  3  3  3  3  1  1  1  1  1  1  1  9  9  1  1  1  3  3  3  3  3  0  0  0  0  0  0  0  0  0  1  1  1  1  1  1  1  3  3  3  3  3  3  3  3  3  3  3  1  1  1  1  1  1  1  1  1  1  1  1  0  0  0  0  0  0  0  0  0  0  0  1  1  1  1  1  1  1  1  1  1  1  1  1  1  1  1  1  1  1  1  1  1  1  1  1  1  5  8  0  8  0  0  0  0  0  2  8  9  8  5  5  5  5  5  1  1  1  3  3  0  0  0  0  0  0  0  0  0  0  0  0  0  0  0  5  2  5  2  5  2  5  6  2  5  6  6  5  6  5  6  6  5  5  5  1  1  1  1  1  1  1  1  0  0  0  0  0  0  0  0  0  0  1  1  0  0  0  0  0  0  0  0  0  0  0  0  0  0  0  0  0  0  0  0  
1  1  1  1  1  1  1  1  1  1  1  1  1  1  1  1  1  1  1  1  1  1  1  1  1  1  2  2  2  2  2  2  2  2  2  1  1  1  1  1  1  1  1  1  1  1  1  1  1  1  1  1  1  1  1  1  1  1  1  1  1  1  1  1  1  9  0  2  2  0  0  0  2  2  0  9  1  1  1  1  1  1  1  1  1  1  1  1  1  1  1  1  1  1  1  1  1  1  1  1  1  1  5  8  0  8  2  8  8  2  8  9  8  8  8  5  5  5  5  5  1  1  1  1  1  0  0  0  0  0  0  0  0  0  0  0  0  3  0  0  5  6  5  6  5  6  5  5  6  5  5  5  5  5  5  5  5  5  5  5  1  1  1  1  1  1  1  1  6  6  6  6  6  6  6  6  6  6  1  1  2  2  2  2  2  2  2  2  2  2  2  2  2  2  2  2  2  2  2  2  
1  1  1  1  1  1  1  1  1  1  1  1  1  1  1  1  1  1  1  1  1  1  1  1  1  1  9  9  9  9  9  9  9  9  9  1  1  1  1  1  1  1  1  1  1  1  1  1  1  1  1  1  1  1  1  1  1  1  1  1  1  1  1  1  1  1  3  3  3  3  3  3  3  3  3  1  1  1  1  1  1  1  1  1  1  1  1  1  1  1  1  1  1  1  1  1  1  1  1  1  1  1  5  8  8  8  9  8  8  9  8  8  8  5  5  5  5  5  5  5  1  1  1  1  1  2  2  2  2  2  2  2  2  2  2  2  2  1  2  2  5  5  5  5  5  5  5  5  5  5  5  5  5  5  5  5  5  5  5  5 11 11 11 11 11 11 11 11 11 11 11 11 11 11 11 11 11 11 11 11 11 11 11 11 11 11 11 11 11 11 11 11 11 11 11 11 11 11 11 11  

